03 02 02 02 02 02 02 02 02 02 02 02 02 02 02 02 02 02 06 02 02 02 02 02 02 02 02 06 02 02 02 02 02 02 02 02 02 02 02 04 
01 19 19 19 19 19 19 19 19 19 19 19 19 19 19 19 19 19 01 19 19 19 19 19 19 19 19 01 19 19 19 19 19 19 19 19 19 19 19 01 
01 19 19 19 19 19 19 19 19 19 19 19 19 19 19 19 19 19 01 19 19 19 19 19 19 19 19 15 19 19 19 19 19 19 19 19 19 19 19 01 
01 19 19 19 19 19 19 19 19 19 19 19 19 19 19 19 19 19 15 19 19 19 19 19 19 19 19 19 19 19 19 19 19 19 19 19 19 19 19 01 
01 19 19 19 03 02 02 18 19 19 19 19 17 19 19 19 19 19 19 19 19 19 17 19 19 19 19 19 19 19 19 19 19 17 19 19 19 19 19 01 
01 19 19 19 01 19 19 19 19 19 19 19 01 19 19 19 19 19 19 19 19 19 01 19 19 19 19 19 19 19 19 19 19 01 19 19 19 19 19 01 
01 19 19 19 01 19 19 19 19 19 19 19 01 19 19 19 19 19 19 19 19 19 01 19 19 19 19 19 19 03 02 02 02 11 19 19 19 19 19 01 
01 19 19 19 01 19 19 19 19 19 19 19 01 19 19 19 19 19 19 19 19 19 10 02 02 02 06 02 02 11 19 19 19 19 19 19 19 19 19 01 
01 19 19 19 01 19 19 19 19 19 19 19 01 19 19 19 17 19 19 19 19 19 19 19 19 19 01 19 19 19 19 19 19 19 19 19 19 19 19 01 
01 19 19 19 15 19 19 19 19 16 02 02 08 02 02 02 11 19 19 19 19 19 19 19 19 19 01 19 19 19 19 19 19 19 19 19 19 19 19 01 
01 19 19 19 19 19 19 19 19 19 19 19 01 19 19 19 19 19 19 19 19 19 19 19 19 19 15 19 19 19 19 19 16 04 19 19 19 19 19 01 
01 19 19 19 19 19 19 19 19 19 19 19 01 19 19 19 19 19 19 19 03 18 19 19 19 19 19 19 19 19 19 19 19 01 19 19 19 19 19 01 
01 19 19 19 19 19 19 19 19 19 19 19 01 19 19 19 19 19 19 19 01 19 19 19 19 19 19 19 19 19 19 19 19 01 19 19 19 19 19 01 
01 19 19 19 19 19 19 19 19 19 19 19 10 02 18 19 19 19 19 19 01 19 19 19 19 19 19 19 19 19 19 19 19 01 19 19 19 19 19 01 
01 19 19 19 19 19 19 19 19 19 19 19 19 19 19 19 19 19 19 19 05 02 02 02 02 02 02 02 02 02 06 02 02 11 19 19 19 19 19 01 
01 19 19 19 19 19 19 19 19 19 19 19 19 19 19 19 19 19 19 19 01 19 19 19 19 19 19 19 19 19 01 19 19 19 19 19 19 19 19 01 
01 19 19 19 16 02 02 02 04 19 19 19 19 19 19 19 19 19 19 19 01 19 19 19 19 19 19 19 19 19 01 19 19 19 19 19 19 19 19 01 
01 19 19 19 19 19 19 19 01 19 19 19 19 19 19 19 19 19 19 19 01 19 19 19 19 19 19 19 19 19 01 19 19 19 19 19 19 19 19 01 
01 19 19 19 19 19 19 19 01 19 19 19 19 16 02 02 02 02 02 02 12 18 19 19 19 19 19 19 19 19 01 19 19 19 19 19 19 19 19 01 
01 19 19 19 19 19 19 19 01 19 19 19 19 19 19 19 19 19 19 19 19 19 19 19 19 19 19 19 19 19 10 02 02 18 19 19 19 19 19 01 
01 19 19 19 19 19 19 19 15 19 19 19 19 19 19 19 19 19 19 19 19 19 19 19 19 19 19 19 19 19 19 19 19 19 19 19 19 19 19 01 
01 19 19 19 19 19 19 19 19 19 19 19 19 19 19 19 19 19 19 19 19 19 19 19 19 19 19 19 19 19 19 19 19 19 19 19 19 19 19 01 
01 19 19 19 19 19 19 19 19 19 19 19 19 19 19 19 19 19 19 19 19 19 19 19 19 19 19 19 19 19 19 19 19 19 19 19 19 19 19 01 
10 02 02 02 02 02 02 02 02 02 02 02 02 02 02 02 02 02 02 02 02 02 02 02 02 02 02 02 02 02 02 02 02 02 02 02 02 02 02 11 
